00000000000000000000
11111101111111111110
11111101111111111110
11111101111111111110
11111101111111111110
11111101111111111110
01111111111111011110
00000000000000000000
01111111111110000111
01111111111110110111
01111111111110000111
01111111111111111111
00000000000000000000
