00111111111111111111
10011111111111111111
11001111111111111111
11100000000000001111
11101111101111101111
11101111101111101111
11100000000000001111
11101111101111101111
11101111101111101111
11100000000000000111
11111111111111110011
11111111111111111001
11111111111111111100
