00000000000000000000
11110111111110111110
11110001111000111110
11111101111010111110
11111100000010111110
11111111111110111110
11000000000000000000
00011111011111111111
01111111011111110000
00000000000000010110
01111110111111000110
01111111111111111110
00000000000000000000
