01111111100000001111
01111111101111100001
01000000000011101101
00011101111011101111
11111101111000000111
11111101111011110111
11000000001000110111
10011111101110110000
10111000101110111110
10011010100000011110
11000010101111011110
11111011101111011110
11111000000000000000

