00000000000000000001
11111110111111111101
11111110111111111101
11111110111111111101
11111110111111111101
00000000000000000001
01101111110111111111
01101111110111111111
00001111110111111111
01111111110111111111
01111111111111111111
01111111111111111111
00000000000000000000
