11111111111111111110
00000001000000000010
00000001000000000010
00000001000000000010
00000001000000000010
11111111111111111110
10010000001000000000
10010000001000000000
11110000001000000000
10000000001000000000
10000000000000000000
10000000000000000000
11111111111111111111


00000000000000000000
00000000000000000000
00000000000000000000
00000000000000000000
00000000000000000000
00000000000000000000
00000000000000000000
00000000000000000000
00000000000000000000
00000000000000000000
00000000000000000000
00000000000000000000
00000000000000000000
